11111111111111111
1PNNNN001111NNNN1
1001CC00000010001
100CC0000C0010N01
10N00000100000NC1
10NC0000110000NC1
10N100001111N00E1
11111111111111111